hello=hola
goodbye=adiós
please=por favor
thank you=gracias
sorry=lo siento
yes=sí
no=no
maybe=quizás
how are you=¿cómo estás?
good=bueno
bad=malo
man=hombre
woman=mujer
child=niño
friend=amigo
house=casa
car=coche
door=puerta
window=ventana
table=mesa
chair=silla
book=libro
school=escuela
teacher=profesor
student=estudiante
water=agua
bread=pan
milk=leche
cheese=queso
coffee=café
tea=té
beer=cerveza
wine=vino
apple=manzana
dog=perro
cat=gato
day=día
night=noche
morning=mañana
evening=noche
today=hoy
tomorrow=mañana
yesterday=ayer
father=padre
mother=madre
brother=hermano
sister=hermana
love=amor
time=tiempo
money=dinero
