pies = dog
dog = pies
kot = cat
cat = kot
samochód = car
car = samochód
droga = road
road = droga
dziecko = child
child = dziecko
matka = mother
mother = matka
ojciec = father
father = ojciec
brat = brother
brother = brat
siostra = sister
sister = siostra
miłość = love
love = miłość
nienawiść = hate
hate = nienawiść
szkoła = school
school = szkoła
nauczyciel = teacher
teacher = nauczyciel
uczeń = student
student = uczeń
książka = book
book = książka
stół = table
table = stół
krzesło = chair
chair = krzesło
okno = window
window = okno
drzwi = door
door = drzwi
jabłko = apple
apple = jabłko
chleb = bread
bread = chleb
masło = butter
butter = masło
ser = cheese
cheese = ser
mleko = milk
milk = mleko
woda = water
water = woda
kawa = coffee
coffee = kawa
herbata = tea
tea = herbata
piwo = beer
beer = piwo
wino = wine
wine = wino
dzień = day
day = dzień
noc = night
night = noc
rano = morning
morning = rano
wieczór = evening
evening = wieczór
tydzień = week
week = tydzień
miesiąc = month
month = miesiąc
rok = year
year = rok
dzisiaj = today
today = dzisiaj
jutro = tomorrow
tomorrow = jutro
wczoraj = yesterday
yesterday = wczoraj
tak = yes
yes = tak
nie = no
no = nie
może = maybe
maybe = może
proszę = please
please = proszę
dziękuję = thank you
thank you = dziękuję
przepraszam = sorry
sorry = przepraszam
cześć = hello
hello = cześć
do widzenia = goodbye
goodbye = do widzenia
jak się masz = how are you
how are you = jak się masz
dobrze = good
good = dobrze
źle = bad
bad = źle
